GENDER,AGE,SMOKING,YELLOW_FINGERS,ANXIETY,PEER_PRESSURE,CHRONIC_DISEASE,FATIGUE,ALLERGY,WHEEZING,ALCOHOL_CONSUMING,COUGHING,SHORTNESS_OF_BREATH,SWALLOWING_DIFFICULTY,CHEST_PAIN,LUNG_CANCER
1,69,1,2,2,1,1,2,1,2,2,2,2,2,2,1
1,74,2,1,1,1,2,2,2,1,1,1,2,2,2,1
0,59,1,1,1,2,1,2,1,2,1,2,2,1,2,0
1,63,2,2,2,1,1,1,1,1,2,1,1,2,2,0
0,63,1,2,1,1,1,1,1,2,1,2,2,1,1,0
0,75,1,2,1,1,2,2,2,2,1,2,2,1,1,1
1,52,2,1,1,1,1,2,1,2,2,2,2,1,2,1
0,51,2,2,2,2,1,2,2,1,1,1,2,2,1,1
0,68,2,1,2,1,1,2,1,1,1,1,1,1,1,0
1,53,2,2,2,2,2,1,2,1,2,1,1,2,2,1
0,61,2,2,2,2,2,2,1,2,1,2,2,2,1,1
1,72,1,1,1,1,2,2,2,2,2,2,2,1,2,1
0,60,2,1,1,1,1,2,1,1,1,1,2,1,1,0
1,58,2,1,1,1,1,2,2,2,2,2,2,1,2,1
1,69,2,1,1,1,1,1,2,2,2,2,1,1,2,0
0,48,1,2,2,2,2,2,2,2,1,2,2,2,1,1
1,75,2,1,1,1,2,1,2,2,2,2,2,1,2,1
1,57,2,2,2,2,2,1,1,1,2,1,1,2,2,1
0,68,2,2,2,2,2,2,1,1,1,2,2,1,1,1
0,61,1,1,1,1,2,2,1,1,1,1,2,1,1,0
0,44,2,2,2,2,2,2,1,1,1,1,2,2,1,1
0,64,1,2,2,2,1,1,2,2,1,2,1,2,1,1
0,21,2,1,1,1,2,2,2,1,1,1,2,1,1,0
1,60,2,1,1,1,1,2,2,2,2,2,2,1,2,1
1,72,2,2,2,2,2,1,2,2,2,2,1,2,2,1
1,65,1,2,2,1,1,2,1,2,2,2,2,2,2,1
0,61,2,2,2,1,1,2,2,1,2,1,2,2,2,1
1,69,1,1,1,2,1,2,1,2,1,2,2,1,2,0
0,53,2,2,2,1,2,1,1,2,2,1,2,2,2,1
1,55,1,2,1,1,1,2,1,2,2,2,2,1,1,0
0,57,2,2,1,1,1,1,1,1,1,1,2,1,1,0
1,62,2,1,2,1,1,1,2,2,2,1,2,2,2,1
1,56,2,2,2,1,1,1,1,1,1,1,2,2,1,0
0,67,2,2,2,1,2,1,1,1,1,1,2,2,2,1
1,59,1,2,2,1,1,1,1,1,1,1,1,2,2,0
0,59,2,2,2,1,2,1,1,1,1,1,2,2,1,1
1,60,1,2,1,1,2,1,1,2,1,2,2,1,2,1
0,56,1,1,1,1,2,1,1,2,1,1,2,2,1,0
1,56,2,1,1,1,2,1,1,2,1,1,2,1,2,1
1,60,2,1,1,1,2,1,2,2,2,2,1,1,2,1
1,68,2,1,2,1,1,2,2,1,2,2,2,1,2,1
1,63,1,1,1,2,1,2,2,2,2,1,1,2,1,1
0,77,1,2,2,2,2,2,1,2,2,1,1,1,1,1
1,52,2,1,1,2,1,2,2,2,2,1,2,1,2,1
0,70,2,2,1,2,2,1,1,1,2,2,1,2,1,1
1,72,2,2,2,2,2,2,1,2,2,2,2,2,2,1
1,62,2,2,1,1,2,1,2,1,1,2,2,2,2,1
0,64,2,2,1,2,1,2,1,2,2,2,1,2,2,1
0,70,1,1,2,2,2,2,2,2,2,1,2,2,2,1
1,60,1,1,2,2,2,1,1,1,2,1,1,1,1,0
0,56,1,1,1,2,2,2,2,2,2,1,1,1,2,1
1,63,2,2,2,1,2,2,2,2,1,1,2,1,1,1
0,54,2,1,1,2,1,2,2,2,2,2,1,2,2,1
1,49,2,1,1,2,2,2,2,2,2,2,2,2,2,1
0,57,1,2,1,2,2,2,2,1,2,2,1,1,1,1
1,52,1,2,2,1,2,1,2,2,2,2,1,2,1,1
0,63,1,2,1,2,1,2,1,1,1,2,2,1,2,1
1,73,1,1,1,1,2,1,2,1,2,2,2,2,2,1
1,47,1,2,1,2,2,2,1,2,1,1,2,2,2,1
1,69,2,2,2,2,1,2,2,1,2,2,2,1,2,1
1,70,1,2,1,2,2,2,2,2,2,2,1,2,2,1
0,60,1,2,2,1,1,1,1,1,1,2,1,1,1,0
1,70,1,2,1,2,1,2,2,2,2,2,1,1,1,1
0,68,1,1,2,1,2,1,2,2,2,1,1,2,1,1
1,74,1,2,1,2,1,2,2,2,2,2,2,1,2,1
0,71,2,2,2,2,2,2,1,2,1,2,1,2,2,1
0,56,1,2,1,1,2,2,2,2,1,2,2,1,2,1
1,66,2,1,1,1,1,2,1,2,2,2,2,1,1,1
0,76,2,2,2,2,1,2,2,1,1,1,2,2,2,1
0,78,2,2,2,2,1,2,1,2,1,2,2,2,1,1
1,68,2,2,2,2,1,1,2,1,2,1,1,2,2,1
0,66,2,2,2,2,1,2,1,2,1,2,2,2,1,1
1,67,1,1,1,1,2,2,2,2,2,2,2,1,2,1
0,60,2,1,1,1,2,2,1,1,1,1,2,1,1,1
1,61,2,1,1,1,1,2,2,2,2,2,2,1,2,1
1,58,2,1,1,1,1,1,2,2,2,2,1,1,1,1
0,76,1,2,2,2,2,2,2,2,1,2,2,2,2,1
1,56,2,1,1,1,1,2,2,2,2,2,2,1,2,1
1,67,2,2,2,2,2,1,1,1,2,1,1,2,2,1
0,73,2,2,2,2,1,2,1,1,1,2,2,2,2,1
0,58,1,1,1,1,1,2,1,1,1,1,2,1,1,0
0,54,2,2,2,2,2,2,1,1,1,1,2,2,1,1
0,62,2,2,2,2,2,1,2,2,2,1,1,2,2,1
0,81,1,1,1,2,2,1,2,1,2,2,2,1,1,1
1,56,1,1,1,1,2,2,2,1,2,2,2,1,2,1
1,60,1,2,2,1,1,1,1,2,2,2,2,2,1,1
1,66,1,2,2,1,2,1,2,1,2,2,2,1,2,1
1,62,1,2,2,1,1,2,1,2,1,1,1,2,2,1
0,62,2,2,2,1,2,1,2,1,2,1,1,1,1,1
0,55,2,1,1,2,2,2,2,2,2,1,1,2,2,1
0,62,1,1,1,2,1,1,1,2,2,1,1,2,2,1
0,71,1,1,1,1,2,2,2,1,1,2,2,1,2,1
1,52,2,1,1,1,2,2,2,2,2,1,1,2,2,1
0,59,1,2,2,2,2,1,2,2,2,2,2,2,1,1
1,48,2,1,1,1,2,2,2,1,2,2,2,2,2,1
1,60,1,2,2,2,1,2,1,1,1,1,1,2,2,1
0,61,2,2,2,1,1,1,2,1,2,2,2,1,2,1
1,59,2,1,1,2,1,1,1,1,2,2,2,1,1,1
1,64,1,2,2,2,1,2,2,1,1,2,1,2,1,1
1,56,2,1,1,1,1,2,2,2,2,2,2,1,2,1
1,58,2,1,1,1,1,1,2,2,2,2,1,1,1,1
0,81,1,2,2,2,2,2,2,2,1,2,2,2,2,1
1,64,2,1,1,1,1,2,2,2,2,2,2,1,2,1
1,62,2,2,2,2,2,1,1,1,2,1,1,2,2,1
0,72,2,2,2,2,1,2,1,1,1,2,2,2,2,1
0,60,1,1,1,1,2,2,1,1,1,1,2,1,1,1
0,61,2,2,2,2,2,2,1,1,1,1,2,2,1,1
0,60,2,2,2,2,2,1,2,2,2,1,1,2,2,1
0,49,1,1,1,2,2,1,2,1,2,2,2,1,1,1
1,53,1,1,1,1,2,2,2,1,2,1,2,1,2,1
1,58,1,2,2,1,1,2,1,2,2,2,2,2,2,1
1,61,2,2,2,1,1,2,2,1,2,1,2,2,2,1
0,68,1,1,1,2,1,2,1,2,1,2,2,1,2,1
1,60,2,2,2,1,1,1,1,1,2,1,1,2,2,1
0,72,1,2,1,1,1,2,1,2,2,2,2,1,1,1
0,72,1,2,1,1,2,2,2,2,1,2,2,1,1,1
1,57,2,1,1,1,1,2,1,2,2,2,2,1,2,1
0,51,2,2,2,2,1,2,2,1,1,1,2,2,1,1
0,54,2,2,2,2,1,2,1,2,1,2,2,2,1,1
0,56,1,2,2,2,1,1,2,1,2,1,1,2,2,1
1,77,2,2,2,2,1,2,1,2,1,2,2,2,1,1
1,64,1,1,1,1,2,2,2,2,2,2,2,1,2,1
1,57,2,1,2,1,2,2,1,1,1,1,2,1,1,1
0,66,2,2,2,1,2,2,2,2,2,2,2,1,1,1
1,70,2,1,1,1,1,1,2,1,2,2,1,1,2,1
0,53,1,2,2,2,2,2,2,1,1,2,2,1,1,1
1,51,2,1,1,1,1,2,1,2,2,2,2,1,2,1
1,58,2,2,2,2,2,1,1,1,2,1,1,2,2,1
0,58,2,2,2,2,1,2,1,1,1,2,2,2,1,1
0,63,1,1,1,1,2,2,1,1,1,1,2,1,1,0
0,51,2,2,2,2,1,2,1,1,1,1,2,2,1,1
0,61,1,2,2,2,1,1,2,2,1,2,1,2,1,1
0,61,2,1,1,1,2,2,2,1,1,1,2,1,1,1
1,76,2,1,1,1,1,2,2,2,2,2,2,1,2,1
1,71,2,2,2,1,2,1,2,2,2,2,1,2,2,1
1,69,1,1,2,1,1,2,1,2,2,2,2,2,1,1
0,56,2,2,2,1,1,2,2,1,1,1,2,1,2,1
1,67,1,1,1,2,1,2,1,2,1,2,2,1,2,1
0,54,2,2,2,1,2,1,1,2,2,1,2,2,2,1
1,63,1,2,1,1,1,2,1,2,2,2,2,1,1,1
0,47,2,2,1,2,2,2,2,2,1,2,2,1,1,1
1,62,2,1,2,1,1,2,1,2,2,2,2,1,2,1
1,65,2,2,2,2,1,2,2,1,1,1,2,2,1,1
0,63,2,2,2,2,2,2,2,2,1,2,2,2,2,1
1,64,1,2,2,2,1,1,2,1,2,1,1,2,2,1
0,65,2,2,2,2,1,2,1,2,1,2,2,2,1,1
1,51,1,2,1,1,2,2,2,2,2,2,2,1,2,1
0,56,1,1,1,2,2,2,1,1,2,2,2,2,1,1
1,70,2,1,1,1,1,2,2,2,2,2,2,1,2,1
1,58,2,1,1,1,1,1,2,2,2,2,1,1,2,1
1,67,2,1,2,1,1,2,2,1,2,2,2,1,2,1
1,62,1,1,1,2,1,2,2,2,2,1,1,2,1,1
0,74,1,2,2,2,2,2,1,2,2,1,1,1,1,1
1,69,2,1,1,2,1,1,1,1,1,1,1,1,2,0
0,64,2,2,1,2,2,1,1,1,1,1,1,1,1,0
1,75,2,2,2,2,2,1,1,1,1,1,1,1,2,1
1,47,2,2,1,1,2,1,1,1,1,1,1,1,2,0
0,57,2,2,1,2,1,1,1,1,1,1,1,1,2,0
0,56,1,1,2,2,2,2,2,2,2,1,2,2,2,1
1,68,1,1,2,2,2,1,1,1,2,1,1,1,1,0
0,55,1,1,1,2,2,2,2,2,2,1,1,1,2,1
1,62,2,2,2,1,2,2,2,2,1,1,2,1,1,1
0,73,2,1,1,2,1,2,2,2,2,2,1,2,2,1
1,68,2,1,1,2,2,2,2,2,2,2,2,2,2,1
0,75,1,2,1,2,2,2,2,1,2,2,1,1,1,1
1,63,1,2,2,1,2,1,2,2,2,2,1,2,1,1
0,61,1,2,1,2,1,2,1,1,1,2,2,1,2,1
1,62,1,1,1,1,2,1,2,1,2,2,2,2,2,1
1,44,1,2,1,2,2,2,1,2,1,1,2,2,2,1
1,56,2,2,2,2,1,2,2,1,2,2,2,1,2,1
1,54,1,2,1,2,2,2,2,2,2,2,1,2,2,1
0,57,1,2,2,1,1,1,1,1,1,2,1,1,1,0
1,56,1,2,1,2,1,2,2,2,2,2,1,1,1,1
0,69,1,1,2,1,2,1,2,2,2,1,1,2,1,1
1,72,1,2,1,2,1,2,2,2,2,2,2,1,2,1
0,59,2,2,2,2,2,2,1,2,1,2,1,2,2,1
0,70,1,2,1,1,2,2,2,2,1,2,2,1,2,1
1,64,2,1,1,1,1,2,1,2,2,2,2,1,1,1
0,61,2,2,2,2,1,2,2,1,1,1,2,2,2,1
0,72,2,2,2,2,1,2,1,2,1,2,2,2,1,1
1,63,2,2,2,2,1,1,2,1,2,1,1,2,2,1
0,74,2,2,2,2,1,2,1,2,1,2,2,2,1,1
1,71,1,1,1,1,2,2,2,2,2,2,2,1,2,1
0,71,2,1,1,1,2,2,1,1,1,1,2,1,1,0
1,72,2,1,1,1,1,2,2,2,2,2,2,1,2,1
1,77,2,1,1,1,1,1,2,2,2,2,1,1,1,1
0,72,1,2,2,2,2,2,1,1,1,1,1,1,1,1
1,55,2,1,1,1,1,2,1,1,1,1,1,1,1,1
1,65,2,2,2,2,2,1,1,1,1,1,1,1,1,1
0,67,2,2,2,2,1,2,1,1,1,1,1,1,1,1
0,69,1,1,1,1,2,2,1,1,1,1,1,1,1,1
0,55,2,2,2,2,2,2,1,1,1,1,1,1,1,1
0,51,2,2,2,2,2,1,1,1,1,1,1,1,1,1
0,64,1,1,1,2,2,1,1,1,1,1,1,1,1,1
1,63,1,1,1,1,2,2,2,1,2,2,2,1,2,1
1,69,1,2,2,1,1,1,1,2,2,2,2,2,1,1
1,64,1,2,2,1,2,1,2,1,2,2,2,1,2,1
1,59,1,2,2,1,1,2,1,2,1,1,1,2,2,1
0,73,2,2,2,1,2,1,2,1,2,1,1,1,1,1
0,55,2,1,1,2,2,2,2,2,2,1,1,2,2,1
0,63,1,1,1,2,1,1,1,2,2,1,1,2,2,1
0,60,1,1,1,1,2,2,2,1,1,2,2,1,2,1
1,74,2,1,1,1,2,2,2,2,2,1,1,2,2,1
0,65,1,2,2,2,2,1,2,2,2,2,2,2,1,1
1,79,2,1,1,1,2,2,2,1,2,2,2,2,2,1
1,62,1,2,2,2,1,2,1,1,1,1,1,2,2,1
0,71,2,2,2,1,1,1,2,1,2,2,2,1,2,1
1,63,2,1,1,2,1,1,1,1,1,2,2,1,1,0
1,67,1,2,2,2,1,2,2,1,1,2,1,2,1,1
1,55,2,1,1,1,1,2,2,2,2,2,2,1,2,1
1,54,2,1,1,1,1,1,2,2,2,2,1,1,1,1
0,77,1,2,2,2,2,2,2,2,1,2,2,2,2,1
1,58,2,1,1,1,1,2,2,2,2,2,2,1,2,1
1,64,2,2,2,2,2,1,1,1,2,1,1,2,2,1
0,61,2,2,2,2,1,2,1,1,1,2,2,2,2,1
0,62,1,1,1,1,2,2,1,1,1,1,2,1,1,0
0,67,2,2,2,2,2,2,1,1,1,1,2,2,1,1
0,56,2,2,2,2,2,1,2,2,2,1,1,2,2,1
0,70,1,1,1,2,2,1,2,1,2,2,2,1,1,1
1,70,1,1,1,1,2,2,2,1,2,2,2,1,2,1
0,57,1,1,2,2,2,2,2,2,2,1,2,2,2,1
1,61,1,1,2,2,2,1,1,1,2,1,1,1,1,0
0,77,1,1,1,2,2,2,2,2,2,1,1,1,2,1
1,63,2,2,2,1,2,2,2,2,1,1,2,1,1,1
0,62,2,1,1,2,1,2,2,2,2,2,1,2,2,1
1,59,2,1,1,2,2,2,2,2,2,2,2,2,2,1
0,70,1,2,1,2,2,2,2,1,2,2,1,1,1,1
1,71,1,2,2,1,2,1,2,2,2,2,1,2,1,1
0,56,1,2,1,2,1,2,1,1,1,2,2,1,2,1
1,57,1,1,1,1,2,1,2,1,2,2,2,2,2,1
1,78,1,2,1,2,2,2,1,2,1,1,2,2,2,1
1,64,2,2,2,2,1,2,2,1,2,2,2,1,2,1
1,62,1,2,1,2,2,2,2,2,2,2,1,2,2,1
0,49,1,2,2,1,1,1,1,1,1,2,1,1,1,1
1,77,1,2,1,2,1,2,2,2,2,2,1,1,1,1
0,64,1,1,2,1,2,1,2,2,2,1,1,2,1,1
1,63,1,2,1,2,1,2,2,2,2,2,2,1,2,1
0,54,2,2,2,2,2,2,1,2,1,2,1,2,2,1
0,38,1,2,1,1,2,2,2,2,1,2,2,1,2,1
0,75,1,2,2,2,1,1,2,2,1,2,1,2,1,1
0,70,2,1,1,2,2,1,2,1,1,1,2,1,1,1
1,59,2,1,1,1,1,2,2,2,2,2,2,1,2,1
1,77,2,2,2,1,2,1,2,2,1,1,1,2,2,1
1,61,1,1,2,1,2,2,1,2,2,2,2,2,1,1
0,64,2,2,2,1,1,2,2,1,1,1,2,1,2,1
1,59,1,1,1,2,1,2,1,2,1,1,2,1,2,0
0,71,2,2,2,1,2,1,1,2,2,1,2,2,2,1
1,67,1,2,1,1,1,2,1,2,2,2,2,1,1,1
0,64,2,2,1,2,2,2,2,2,1,2,2,1,1,1
1,68,2,1,2,1,1,2,1,1,1,1,1,1,1,0
1,69,2,2,2,2,1,2,2,1,1,1,2,2,1,1
0,64,2,2,2,2,2,2,2,2,1,2,2,2,2,1
1,59,1,2,2,2,2,1,2,1,2,1,1,2,2,1
0,67,2,2,2,2,1,2,1,2,1,2,2,2,1,1
1,74,1,2,1,1,2,2,2,2,2,2,2,1,2,1
0,77,1,1,1,2,2,2,1,1,2,2,2,2,1,1
1,60,2,1,1,1,1,2,2,2,2,2,2,1,2,1
1,64,2,1,1,1,1,1,2,2,2,2,1,1,2,1
1,70,2,1,2,1,1,2,2,1,2,2,2,1,2,1
1,58,1,1,1,2,1,2,2,2,2,1,1,2,1,1
0,59,1,2,2,2,2,2,1,2,2,1,1,1,1,1
1,39,2,1,1,2,1,2,2,2,2,1,2,1,2,1
0,67,1,2,1,1,1,1,1,2,1,2,2,1,1,0
0,71,1,2,1,1,2,2,2,2,1,2,2,1,1,1
1,70,2,1,1,1,1,2,1,2,2,2,2,1,2,1
0,60,2,2,2,2,1,2,2,1,1,1,2,2,1,1
0,55,2,1,2,1,1,2,1,1,1,1,1,1,1,0
1,60,2,2,2,2,2,1,2,1,2,1,1,2,2,1
0,55,2,2,2,2,2,2,1,2,1,2,2,2,1,1
1,55,1,1,1,1,2,2,2,2,2,2,2,1,2,1
0,70,2,1,1,1,1,2,1,1,1,1,2,1,1,0
1,63,2,1,1,1,1,2,2,2,2,2,2,1,2,1
1,64,2,1,1,1,1,1,2,2,2,2,1,1,2,0
0,59,1,2,2,2,2,2,2,2,1,2,2,2,1,1
1,56,2,1,1,1,2,1,2,2,2,2,2,1,2,1
1,64,2,2,2,2,2,1,1,1,2,1,1,2,2,1
0,62,2,2,2,2,2,2,1,1,1,2,2,1,1,1
0,87,1,1,1,1,2,2,1,1,1,1,2,1,1,0
0,77,2,2,2,2,2,2,1,1,1,1,2,2,1,1
0,59,1,2,2,2,1,1,2,2,1,2,1,2,1,1
0,59,2,1,1,1,2,2,2,1,1,1,2,1,1,0
1,55,2,1,1,1,1,2,2,1,1,1,2,1,2,0
1,46,1,2,2,1,1,1,1,1,1,1,1,2,2,0
1,60,1,2,2,1,1,2,1,2,2,2,2,2,2,1
1,58,2,2,2,2,2,1,1,1,2,1,1,2,2,1
0,58,2,2,2,2,1,2,1,1,1,2,2,2,1,1
0,63,1,1,1,1,2,2,1,1,1,1,2,1,1,0
0,51,2,2,2,2,1,2,1,1,1,1,2,2,1,1
0,61,1,2,2,2,1,1,2,2,1,2,1,2,1,1
0,61,2,1,1,1,2,2,2,1,1,1,2,1,1,1
1,76,2,1,1,1,1,2,2,2,2,2,2,1,2,1
1,71,2,2,2,1,2,1,2,2,2,2,1,2,2,1
1,69,1,1,2,1,1,2,1,2,2,2,2,2,1,1
0,56,2,2,2,1,1,2,2,1,1,1,2,1,2,1
1,67,1,1,1,2,1,2,1,2,1,2,2,1,2,1
0,54,2,2,2,1,2,1,1,2,2,1,2,2,2,1
1,63,1,2,1,1,1,2,1,2,2,2,2,1,1,1
0,47,2,2,1,2,2,2,2,2,1,2,2,1,1,1
1,62,2,1,2,1,1,2,1,2,2,2,2,1,2,1
1,65,2,2,2,2,1,2,2,1,1,1,2,2,1,1
0,63,2,2,2,2,2,2,2,2,1,2,2,2,2,1
1,64,1,2,2,2,1,1,2,1,2,1,1,2,2,1
0,65,2,2,2,2,1,2,1,2,1,2,2,2,1,1
1,51,1,2,1,1,2,2,2,2,2,2,2,1,2,1
0,56,1,1,1,2,2,2,1,1,2,2,2,2,1,1
1,70,2,1,1,1,1,2,2,2,2,2,2,1,2,1
1,58,2,1,1,1,1,1,2,2,2,2,1,1,2,1
1,67,2,1,2,1,1,2,2,1,2,2,2,1,2,1
1,62,1,1,1,2,1,2,2,2,2,1,1,2,1,1
